1111111111111144411111111111111
1000000200000200000000200000001
1000000000020000000000000000021
1020000000000000002000000200001
1000000200000200000000200000001
1000000000000000000000000000021
1020200000000002002000000200001
1000000000000000000000200000001
1000000002000000000000000000021
1000200000000000002000000200001
1000000200000000000000200000001
1000000000020000000000000000021
1020200000000000002000000200001
1000000200000220000000200000001
1000000000020000000000000000021
1020200000000000002000000200001
1000000200000200000000202000001
1000000000020000000000000000021
1020200000000000002000000200001
1000000002000000200000000000001
1111111111111103011111111111111